 1  1  1  1  1  1 12 17 18 18 18 18 18 18 18 19  8  1 25 35  4  4  4  4 33 29  1  1 28  1  1  1      1 32  1  1  1  1  1  1  1 14  2 16  6  7  1  1  1  1  1 32  4  4  4  4 36 27  1  1 45 41  1  1
 1  1  1  1  1  1 12 24  3  3  3  3  3  3  3 20  8  1 32  4  4  4  4 33 29  1  1  1 48 39  1  1      1 43 46  1  1  1  1  1  1 11 14  2  2  8  1  1  1  1 25 35  4  4  4  4  4 36 27  1 48 39 37 38
 1  1  1  1  1  1 12 23 22 22 22 22 22 22 22 21  8  1 32  4  4  4 33 29  1  1  1  1 45 41  1  1      1  1 43 46  1  1  1  1  1  5 15  2 13  9  1  1  1  1 31 34  4  4  4  4  4  4 36 27  1 48 47  1
 1  1  1  1  1  1 12 17 18 18 18 18 18 18 18 19  8  1 32  4  4  4 28  1  1  1  1  1 40  1  1  1      1  1  1 43 46  1  1  1  5 15  2 13  9  1  1  5  6  6  7 31 34  4  4  4  4  4  4 36 27  1  1  1
 1  1  1  1  1  1 12 24  3  3  3  3  3  3  3 20  8  1 32  4  4  4 28  1  1  1  1 45 41  1  1  1      1  1  1  1 43 46  1  1 12  2 13  9  1  1  1 12  2 17 19 16 31 34  4  4  4  4  4  4 36 27  1  1
 1  1  1  1  1  1 12 23 22 22 22 22 22 22 22 21  8  1 32  4  4  4 28  1  1  1  1 40  1  1  1  1      1  1  1  1  1 43 46  1 12  2  8  1  1  1  1 12  2 24  3 19 16 31 34  4  4  4  4  4  4 36 27  1
 1  1  1  1  1  1 11 10 10  2 10 10 10 10 10 10  9  1 32  4  4  4 36 27  1  1 45 41  1  1  1  1      1  1  1 44  1  1 44  1 12  2 16  7  1  1  1 12  2 24  3 20 19 16 31 34  4  4  4  4  4  4 36 27 
 6  6  6  6  6  6  6  6  6  2  7  1  1  1  1  1 40  1 32  4  4  4  4 28  1  1 48 39  1  1  1  1      1  1  1 44  1  1 44  1 11 14  2  8  1  1  1  5  2 24  3 20  3 19 16 31 34  4  4  4  4  4  4 36
 2  2  2  2  2  2  2  2  2  2  8  1  1  1  1  1 40  1 31 34  4  4  4 28 17 18 19 40  1  1  1  1      1  1  1 44  1  1 44  1  1 12  2  8  1  1  5 15  2 24  3 20 24  3 20 16 31 34  4  4  4  4  4  4
10 10 10 10 10 10 10 10 14  2  8  1  1 25 26 27 12 17 19 32  4  4  4 28 24  3 20 40  1  1  1  1      1  1  1 44 37 38 47  1  1 12  2  8  1  5 15  2  2 24  3 20 24  3 20 19 16 31 34  4  4  4  4  4
17 18 18 18 18 18 19  2  2  2 16  1  1 32  4 28 12 24 20 32  4  4  4 28 24  3 20 48 39  1  1  1      1  1 44 37 47  1  1  1  1 12  2  8  5 15  2  2  2 24  3 20 24  3 20  3 19 16 31 34  4  4  4  4
24  3  3  3  3  3 20  2  2  2  2 16  1 31 30 29 12 24 20 32  4  4  4 36 27 24 20 45 41  1  1  1      1  1 44 44  1  1  1  1  1 11 14 16 15  2 13  9  2 24  3 20 24  3 20 24  3 20 16 31 34  4  4  4
23 22 22 22 22 22 21 13 10 14  2  2 16  1  1  1 12 24 20 32  4  4  4  4 28 24 20 48 38 39  1  1      1  1  1 44  1  1  1  1  1  1 12  2  2 13  9 12  2 24  3 20 24  3 20 24  3 20 19 16 31 34  4  4
17 18 18 18 18 18 19  8  1  1 14  2  2 16  1  1 12 24 20 32  4  4  4  4 28 24 20  1 45 41  1  1      1  1  1 44  1  1  1  1  1  1 12  2 13  9  1 12  2 24  3 20 24  3 20 24  3 20 24 19 16 31 34  4
24  3  3  3  3  3 20  8  1  1  1 14  2  2 16  6 15 23 21 31 34  4  4  4 28 23 21  1 48 38 38 39      1  1 37 47  1  1  1  1  1  5 15  2  8  1  1 12  2 23 22 21 23 22 21 23 22 21 23 22 22 16 31 34
23 22 22 22 22 22 21  8  1  1  1  1 14  2  2  2 13 10  9  1 32  4  4  4 28  1 14  7  1  1  1 40      1 37 47  1  1  1  1  1  5 15  2 13  9  1  1 11 10 10 10 10 10 10 10 10 10 10 10 10 10  9  9 31

10 10 10 10 10 10 10  9  1  1  1  1 12  2  2  8  1  1  1  1 32  4  4  4 28  1 12  8  1  1  1 48     38 47  1  1  1  1  1  1 12  2 13  9  1  1  1  1  1  1  1  1  1  1  1  1  1  1  1  1  1  1  1  1
 1  1  1  1  1  1  1  1  1  1  1  1 12  2  2 16  6  6  6  6 15  4  4  4 28  1 12  8  1  1  1  1      1  1  1  1  1  1  1  1 12  2  8  1  1  1  1  5  6  6  6  6  6  6  6  6  6  6  6  6  6  6  6  7
 1  1  1  1  1  1  1  1  1  1  1  1 12  2  2  2  2  2  2  2  2  4  4  4 16  6 15 16  7  1  1  1      1  1  1  1  1  1  5  6 15  2 16  7  1  1  1 12  2  2  2  2  2  2  2  2  2  2  2  2  2  2  2  8
 6  6  6  6  6  6  7  5  6  6  6  6 15  2  2  2  2  2  2  2  2  4  4  4  2  2  2  2 16  6  7  1      1  1  1  1  1  5 15  2  2  2  2 16  7  1  1 12  2  2 17 18 18 18 18 18 18 18 18 18 18 19  2  8
17 18 19 17 18 19  8 12 17 18 19 17 18 19  2  2  2  2  2  8 32  4  4  4 13 10 10 14  2  2 16  7      1  1  1  1  5 15  2  2  2  2  2  2 16  7  1 12  2  2 24  3  3  3  3  3  3  3  3  3  3 20  2  8
24  3 20 24  3 20  8 12 24  3 20 24  3 20  2  2  2  2  2  8 32  4  4  4 28  1  1 11 14  2  2 16      6  7  1  5 15  2  2  2 13 14  2  2  2 16  7 12  2  2 24  3  3  3  3  3  3  3  3  3  3 20  2  8
24  3 20 24  3 20  8 12 24  3 20 24  3 20  2  2  2  2  2  8 32  4  4  4 36 27  1  1 11 10 10 14      2 16  6 15  2  2  2 13  9 11 14  2  2  2 16  7  2  2 24  3  3  3  3  3  3  3  3  3  3 20  2  8
24  3 20 24  3 20  8 12 24  3 20 24  3 20  2  2  2  2  2  8 32  4  4  4  4 36 27  1  1  1  1 11     14  2  2  2  2 13 10  9  1  1 11 14  2  2  2 16  2  2 24  3  3  3  3  3  3  3  3  3  3 20  2  8
24  3 20 24  3 20  8 12 24  3 20 24  3 20  2  2  2  2  2  8 32  4  4  4  4  4 36 27  1  1  1  1     12  2  2  2  2  8  1  1  1  1  1 11 14  2  2  2  2  2 24  3  3  3  3  3  3  3  3  3  3 20  2  8
24  3 20 24  3 20  8 12 24  3 20 24  3 20  2  2  2  2  2  8 32  4  4  4  4  4  4 36 27  1  1  1     11 14  2  2  2  9  1  1  1  1  1  1 11 14  2  2  2  2 24  3  3  3  3  3  3  3  3  3  3 20  2  8
24  3 20 24  3 20  8 12 24  3 20 24  3 20  2  2  2  2  2 16 31 30 34  4  4  4  4  4 36 27  1  1      1 25 27  2 25 26 26 26 27  1  1  1  1 11 14  2  2  2 23 22 22 22 22 22 22 22 22 22 22 21  2  8
24  3 20 24  3 20  8 12 24  3 20 24  3 20  2  2  2  2  2  2 16  1 31 34  4  4  4  4  4 36 27  1      1 32 36 26 35  4  4  4 36 27  1  1  1  1 11 14  2  2  2  2  2  2  2  2  2  2  2  2  2  2  2  8
24  3 20 24  3 20  8 12 24  3 20 24  3 20  2  2  2  2 13 14  2 16  7 31 34  4  4  4  4  4 36 26     26 35  4  4  4  4  4  4  4 36 26 27  1  1  1 11 14  2  2  2 13 10 10 10 10 10 10 10 10 10 10  9
23 22 21 23 22 21 16 15 23 22 21 23 22 21  2  2  2 13  9 12  2  2 16  7 31 34  4  4  4  4  4  4      4  4  4  4  4  4  4  4  4  4  4 36 27  1  1  1 12  2  2  2 16 15 17 18 18 18 18 18 18 18 19  8
 2  2  2  2  2  2  2  2  2  2  2  2  2  2  2  2 13  9  1 11 14  2  2 16  7 32  4  4  4  4  4  4      4 33 30 30 34  4  4  4  4  4  4  4 36 26 27  1 12  2  2  2  2  2 23 22 22 22 22 22 22 22 21  8
11 10 10 10 10 10 10 10 10 10 10 10 10 10 10 10  9  1  1  1 11 14  2  2  8 32  4  4  4  4  4  4     33 29 45 46 31 30 30 34  4  4  4  4  4  4 36 27 11 14  2  2  2  2 13 10 10 10 10 10 10 10 10  9

 1  1  1  1  1  1  1  1  1  1  1  1  1  1  1  1  1  1  1  1  1 12  2  2  8 32  4  4  4  4  4 33     29 45 41 45 46  1 25 35  4  4  4  4  4  4  4 28  1  1 11 14  2  2 16  6  6  6  6  6  6  6  6  7
 1  5  6  6  6  6  6  6  6  6  6  6  6  6  6  6  7  1  1  1  1 11 14  2  8 31 34  4  4  4  4 28      1 48 39 48 47 25 35  4  4  4  4  4  4  4  4 36 26 27  1 11 14  2  2  2  2  2  2  2  2  2  2  8
 1 12 17 18 18 18 18 18 18 18 18 18 18 18 18 19  8  1  1  1  1  1 11 14 16  7 31 34  4  4  4 36     26 27 48 39 46 31 34  4  4  4  4  4  4  4  4  4  4 36 27  1 11 10 14  2  2  2  2  2  2  2  2  8
 1 12 24  3  3  3  3  3  3  3  3  3  3  3  3 20  8  1  1  1  1  1  1 12  2  8  1 32  4  4  4  4      4 36 27 40 44  1 32  4  4  4  4  4  4  4  4  4  4  4 28  1  1  1 12  2  2  2  2  2  2  2  2  8
 1 12 24  3  3  3  3  3  3  3  3  3  3  3  3 20  8  1  1  1  1  1  5 15  2  8  1 31 34  4  4  4      4 33 29 48 47 25 35  4  4  4  4  4  4  4  4  4  4  4 28  1  1  1 12  2  2  2  2  2  2  2  2  8
 1 12 24  3  3  3  3  3  3  3  3  3  3  3  3 20  8  1  1  5  6  6 15  2 13  9  1  1 32  4  4  4      4 36 27  1 25 35  4  4  4  4  4  4  4  4  4  4  4  4 36 27  1  1 12  2  2  2  2  2  2  2  2  8
 1 12 24  3  3  3  3  3  3  3  3  3  3  3  3 20  8  1  5 15  2  2 13 10  9  1  1 25 35  4  4  4      4  4 36 26 35  4  4  4  4  4  4  4  4  4  4  4  4  4  4 36 27  1 11 10 10 10 14  2  2  2  2  8
 1 12 24  3  3  3  3  3  3  3  3  3  3  3  3 20 16  6 15  2  2 13  9  1  1  1 25 35  4  4  4  4      4  4  4  4  4  4  4  4  4  4  4  4  4  4  4  4 33 34  4  4 36 27  1  1  1  1 11 14  2  2  2  8
 1 12 24  3  3  3  3  3  3  3  3  3  3  3  3 20  2  2  2  2 13  9  1  1  1 25 35  4  4  4  4  4      4  4  4  4  4  4  4  4  4  4  4  4  4  4  4 33 29 31 34  4  4 36 26 26 26 26 27 11 14  2  2  8
 1 12 24  3  3  3  3  3  3  3  3  3  3  3  3 20  2  2  2  2  8  1  1  1  1 32  4  4  4  4  4  4      4  4  4  4  4  4  4  4  4 33 30 34  4  4 33 29  1  1 32  4  4  4  4  4  4  4 36 27 11 10 10  9
 1 12 23 22 22 22 22 22 22 22 22 22 22 22 22 21  2  2  2 13  9  1  1  1 25 35  4  4  4  4  4  4      4  4  4  4  4  4  4  4 33 29  2 31 30 30  1  1  1  1 31 30 30 34  4  4 33 34  4 36 27  1  1 25
 1 11 10 10 10 10 10 10 10 10 10 10 10 10 10 14  2  2  2  8  1  1  1 25 35  4  4  4  4  4  4  4      4  4  4  4  4  4  4 33 29  5  2  8  1  1  1  1  1  1  1  1  1 32  4 33 29 32  4  4 36 26 26 35
 1  1  1  1  1  1  1  1  1  1  1  1  1  1  1 12  2  2 13  9  1  1  1 32  4  4  4  4 33 30 30 34      4  4  4  4  4  4 33 29  5 15  2  8  1  1  1  1  1  1  1  1  1 31 30 29  1 32  4  4  4  4  4  4
39  1  1  1  1  1  1  1  1  1  1  1  1  1  5 15  2 13  9  1  1  1  1 32  4  4  4 33 29  1  1 31     30 34  4  4  4 33 29  5 15  2 13  9  1  1  1  1  1  1  1  1  1  1  1  1  1 31 30 30 34  4  4  4
48 39  1  1  1  1  1 45 46  1  1  1  1  1 15  2 13  9  1  1 25 26 26 35  4  4 33 29  1  1  1  1      1 31 34  4  4 28  1 12  2  2  8  1  1  1  1  1  1  1  1  1  1  1  1  1  1  1  1  1 31 34  4 33
 1 48 38 38 38 39  1 48 47  1 37 38 38 47  2  2  8 25 26 26 35  4  4  4  4  4 28  1  1  1  1  1      1  1 31 30 30 29  5 15 13 10  9  1  1  1  1  1  1  1  1  1  1  1  1  1  1  1  1  1  1 31 30 29

26 26 26 27  1 48 38 38 38 38 47  1  1 12  2  2  8 32  4  4  4  4 33 30 30 30 29  1  1  1  1  1      1  1  1  5  6  6 15 13  9  1  1  1  1  1  1  1  1  1  1  1  1  1  1  1  1  1  1  1  1  1  1  1
 4  4  4 36 27  1  1  1  1  1  1  1 25 15  2  2 16 35  4  4  4 33 29  1  1  1  1  1  1  1  1  1      1  1  5 15  2  2 13  9  1  1  1  1  1  1  1  1  1  1  1  1  1  1  1  1  1  1  1  1  1  1  1  1
 4  4  4  4 36 26 27  1  1  1  1 25 35  4  4  4  4  4  4  4 33 29  1  1  1  1  1  1  1  1  1  1      1  5 15  2  2 13  9  1  1  1  1  1  1  1  1  1  1  1  1  1  1  1  1  1  1  1  1  1  1  1  1  1
 4  4  4  4  4  4 36 26 26 26 26 35  4  4  4  4  4  4  4 33 29  1  1  1  1  1  1  1  1  1  1  1      5 15  2  2 13  9  1  1  1  1  1  1  1  1  1  1  1  1  1  1  1  1  1  1  1  1  1  1  1  1  1  1
 4  4  4  4  4  4  4  4  4  4  4  4  4  4  4  4 33 30 30 29  1  1  1  1  1  1  1  5  6  6  6  6     15  2  2 13  9  1  1  1  1  1  1  1  1  1  1  1  1  1  1  1  1  1  1  1  1  1  1  1  1  1  1  1
34  4  4  4  4  4  4  4  4  4 33 34  4 33 30 30 29  1  1  1  1  1  1  1  1  5  6 15  2  2  2  2     13 10 10  9  1  1  1  1  1  1  1  1  1  1  1  1  1  1  1  1  1  1  1  1  1  1  1  1  1  1  1  1
31 30 30 34  4  4  4  4  4 33 29 31 30 29 12  2  7  1  1  1  1  1  1  1  5 15  2  2 13 10 10 10      9  1  1  1  1  1  1  1  1  1  1  1  1  1  1  1  1  1  1  1  1  1  1  1  1  1  1  1  1  1  1  1
 1  1  1 31 30 30 34  4 33 29  1  1  1  1 12  2  8  1  1  1  1  1  1  5 15  2  2 13  9  1  1  1      1  1  1  1  1  1  1  1  1  1  1  1  1  1  1  1  1  1  1  1  1  1  1  1  1  1  1  1  1  1  1  1
 1  1  1  1  1  1 31 30 29  1  1  1  1  1 12  2 16  7  1  1  1  1  5 15  2  2 13  9  1  1  1  1      1  1  1  1  1  1  1  1  1  1  1  1  1  1  1  1  1  1  1  1  1  1  1  1  1  1  1  1  1  1  1  1
 1  1  1  1  1  1  1  1  1  1  1  1  1  1 11 14  2 16  6  6  6  6 15  2  2 13  9  1  1  1  1  1      1  1  1  1  1  1  1  1  1  1  1  1  1  1  1  1  1  1  1  1  1  1  1  1  1  1  1  1  1  1  1 45
 1  1  1  1  1  1  1  1  1  1  1  1  1  1  1 11 14  2  2  2  2  2  2 13 10  9  1  1  1  1  1  1      1  1  1  1  1  1  1  1  1  1  1  1  1  1  1  1  1  1  1  1  1  1  1  1  1  1  1  1  1 45 42 41
 1  1  1  1  1  1  1  1  1  1  1  1  1  1  1  1 11 10 10 10 10 10 10  9  1  1  1  1  1  1  1  1      1  1  1  1  1  1  1  1  1  1  1  1  1  1  1  1  1  1  1  1  1  1  1  1  1  1  1 45 42 41  1  1
 1  1  1  1  1  1  1  1  1  1  1  1  1  1  1  1  1  1  1  1  1  1  1  1  1  1  1  1  1  1  1  1      1  1  1  1  1  1  1  1  1  1  1  1  1  1  1  1  1  1  1  1  1  1  1  1  1  1 45 41  1  1  1  1
 1  1  1  1  1  1  1  1  1  1  1  1  1  1  1  1  1  1  1  1  1  1  1  1  1  1  1  1  1  1  1  1      1  1  1  1  1  1  1  1  1  1  1  1  1  1  1  1  1  1  1  1  1  1  1  1  1  1 48 39  1  1  1 45
 1  1  1  1  1  1  1  1  1  1  1  1  1  1  1  1  1  1  1  1  1  1  1  1  1  1  1  1  1  1  1  1      1  1  1  1  1  1  1  1  1  1  1  1  1  1  1  1  1  1  1  1  1  1  1  1  1  1  1 40  1  1 45 41
 1  1  1  1  1  1  1  1  1  1  1  1  1  1  1  1  1  1  1  1  1  1  1  1  1  1  1  1  1  1  1  1      1  1  1  1  1  1  1  1  1  1  1  1  1  1  1  1  1  1  1  1  1  1  1  1  1  1 45 41  1 45 41  1